ARENA:
8821
2B0000000000002C0000000000002D
130000000000000000000000000000
000000000000000000000000000000
000003000000000000000000000000
2E000000000000000000000000002F
000000002A00000900000000000000
000010000000000000000000000000
000000000000000000002400000000
000000000000000000000000000000
300000000000003100000000002832
